1111111111111111111111111111111111
1000000000000000000000000000000001
10P000000000000000000C0000C0000001
1000000000000000000000000000000001
10000C0000000000000000000000000001
100000000000000C000000000000000001
10000000X0000000000000000000C00001
100000000000C0000000C0000000000001
100000000C000000000000000000000001
100000000000000000000000C000000001
1000000000000C00000000000000000001
1000000000000000000000000000000001
100000C00X00000X000C00000000000001
1000000000000000000000000000000001
1000000000C00000000000000000000001
1000C000000000000000000000000C0001
1000000000000000000000000000000001
1000000C0000000000000C000000000E01
1000000000000000000000000000000001
1111111111111111111111111111111111