1111111111111
1010000CCC001
1111000000011
10P0000E00001
1111111c11111