1111111111111111111111111111111111
1E0000000000000C000V0C0000000000F1
1010X101001000001010010V0000010101
1010V1001010101V001001000V00010101
1P00000V0C00C00000000000000V0000C1
1111111111111111111111111111111111