11111111111111111111
1000000P0000C0000001
100000000C00000000E1
1000000000X0000C0001
11111111111111111111