111111111111111
10000000000C001
100C0000P000001
110111000011111
1E00000C0X11111
111111111111111