11111111111111111111
100000000000C0000001
1F000P000C00000000E1
1000000000X0000C0001
11111111111111111111