111111111
100X00C01
10P000001
10C000E01
10X0000X1
111111111