111111111
100C00001
1P00000E1
100C0X001
111111111