11111111111
1P0000000E1
10110001101
1010C000101
100001X0001
10001110001
10X00100001
101000X0101
1C110001101
100000C0001
11111111111